#################################
#        #                #  #	E
S  ##    #  ########    # #  #  #
#####    #         #    # #  #  #
#        # # #     #  	# #  #  #
#######  #   #     #  	###  #  #
#     #  #   #     #         #  #
# #####  #   #     #    # #  #  # 
#                  #    # #  #  #
###########   ######    ###  #  #
#             #                 #
#################################