#################
#S#___#T#_____#_E             
#_#_#_#_#___#_#_#
#___#___#___#_#_#
#___#B______#___#
#################
