# # # # # # # # # # # #
# . . . # . . . . . . #
S . # . # . # # # # . #
# # # . # . . . . # . #
# . . . . # # # . # . E
# # # # . # . # . # . #
# . . # . # . # . # . #
# # . # . # . # . # . #
# . . . . . . . . # . #
# # # # # # . # # # . #
# . . . . . . # . . . #
# # # # # # # # # # # # 