#########
s_#___#_e				                
#_#_#_#_#
#_#_#_#_#
#___#___#	
#########	
