#################
#S#___#T#B____#_E             
#B#_#_#_#___#_#_#
#BT_#___#___#_#_#
#T_B#_______#___#
#################
