#################
#_#___#_#_____#_e             
#_#_#_#_#___#_#_#
#___#___#___#_#_#
#___#_______#___#
#################
